%%%%%%%%%%%%%%%%%%%%%%
%%%%%%%%%%.%%%%%%%%%%%
%%%%%%%%%% %%%%%%%%%%%
%%%%%%%%%% %%%%%%%%%%%
%%%%%%%%%% %%%%%%%%%%%
%%%%%%%%%% %%%%%%%%%%%
%%%%%%%%%% %%%%%%%%%%%
%%%%%%%%%% %%%%%%%%%%%
%%%%%%%%%% %%%%%%%%%%%
%%%%%%%%%% %%%%%%%%%%%
%%%%%%%%%% %%%%%%%%%%%
%         P         .%
%%%%%%%%%% %%%%%%%%%%%
%%%%%%%%%% %%%%%%%%%%%
%%%%%%%%%% %%%%%%%%%%%
%%%%%%%%%% %%%%%%%%%%%
%%%%%%%%%% %%%%%%%%%%%
%%%%%%%%%% %%%%%%%%%%%
%%%%%%%%%% %%%%%%%%%%%
%%%%%%%%%% %%%%%%%%%%%
%%%%%%%%%% %%%%%%%%%%%
%%%%%%%%%%.%%%%%%%%%%%
%%%%%%%%%%%%%%%%%%%%%%