%%%%%%%%%
%   %   %
% % % % %
% % % % %
% % % % %
% % % % %
% % % % %
% % % % %
% % % % %
% % % % %
% % % % %
% % % % %
% % % % %
% % % % %
% % % % %
% % % % %
% % % % %
% %   % %
% %%%%% %
%P     .%
%%%%%%%%%
